BRRRBRBBBR
RRBRRRBBBR
BRBRRBBBBR
BRRRRRBBBR
BBRRRRRRRR
BBRRBBBBRR
BBRRRRRRRB
RRRRBBBBRR
BBRRBBBBBR
BBRRRRRRRR