BBBBBBRBBBBRBBB
RRRRRRRRRRRRBBB
BRBBRBRBBBBRBBB
BRBBRBRRRRRRRRR
BRBBRBRBBBBRBBB
BRBBRBRBBBBRBBB
BRBBRBRRRRRRRRB
BRRRRBRBRBBBRBB
BRBBRBRBRBBBRBB
BRBBRRRBRBBBRBB
BRBRRBRRRBBBRBB
BRBRBBRRRBBBRBB
BRBRBBRRRRRRRBB
BRBRRRRBBBBBBBB
BRBBBBRBBBBBBBB